                    11
                111111
        11111111111111
1111111111111111111111
        10000000001
  1111110000N000011
111100000000000000111
1000000000000000000011
11111111111111111111111
111 11111 11111 11111111  1 
11  1111   1111  11111
1    11     11    111
     1      1     11
     1             1
                   1
                   1

                   1