        	   NO ./path_to_the_north_texture
SO ./path_to_the_south_texture
WE ./path_to_the_west_texture
EA ./path_to_the_east_texture
F 220,100,0
C -22P5,30,0

               1 
                11
                  111
                111011
1        11111111111111
1111111111111111111111
1       110000000001
  1111110000N000011
111100000000000000111
1000000000000000000011
11111111111111111111111    1
111 11111 11111 11111111  101
11  1111   1111  11111     1
1    11     11    111
     1      1     11
     1             1
                   1
                   1

                   1
                   1